1,2,6,2,7,2,4,2,5,2,3,9,12,9,13,14,17,14,9,15,9,16,9,14,17,3,18,3,21,3,18,3,17,14,13,9,9,16,9,9,12,9,3,19,22,11,23,24,23,11,25,0,0,0,0,0,0,0,0
1,2,6,2,7,2,4,2,5,2,3,9,12,9,13,14,17,3,18,3,18,3,17,14,9,15,9,16,9,14,17,3,21,3,18,3,21,3,18,3,17,14,13,14,9,15,9,16,9,0,0,0,0,0,0,0,0,0,0
1,2,4,2,5,2,7,2,3,9,12,9,13,14,17,3,18,3,17,14,9,15,9,16,9,9,3,11,11,22,19,3,20,3,11,11,23,24,23,11,25,11,11,3,9,9,14,17,3,21,3,18,3,17,14,9,15,9,14
1,2,4,2,6,2,9,9,15,9,16,9,9,13,9,12,9,3,9,9,14,17,3,18,3,21,3,18,3,17,14,9,15,9,16,9,9,13,9,12,9,3,19,20,3,19,22,0,0,0,0,0,0,0,0,0,0,0,0
1,2,4,2,5,2,7,2,6,2,3,9,12,9,13,14,9,15,9,16,9,14,17,3,18,3,21,3,17,14,13,9,9,14,17,3,18,3,17,14,9,15,9,16,9,9,13,9,12,9,3,11,11,22,0,0,0,0,0
