1,2,3,17,14,9,15,9,14,13,8,3,10,11,23,11,25,11,10,3,17,3,21,3,17,14,9,16,9,14,13,14,17,3,20,3,2,7,2,5,2,4,2,3,19,22,11,23,24,23,11,25,11,22,19,3,17,3,18
1,2,8,3,17,3,17,14,9,15,9,14,17,3,10,11,25,11,10,3,17,3,21,3,18,3,17,14,13,14,17,3,20,3,17,14,13,8,2,5,2,3,10,11,22,19,3,2,7,2,3,10,11,23,24,23,11,25,11,22,19,3,17,14,9,16,9,2,4
1,2,8,3,17,3,21,3,17,14,9,15,9,14,17,3,18,3,21,3,17,14,13,14,17,3,20,3,19,22,11,23,24,23,11,25,11,10,3,2,7,2,8,13,8,2,5,2,9,16,9,2,4
1,2,8,3,17,3,21,3,17,14,9,15,9,14,17,3,18,3,17,3,20,3,19,22,11,23,24,23,11,25,11,10,3,2,7,2,5,2,8,13,14,9,16,9,14,17,3,21,3,17,3,2,4
1,2,8,3,17,14,9,15,9,14,17,3,21,3,18,3,17,14,13,14,17,3,20,3,19,22,11,23,24,23,11,10,3,2,7,2,4,2,5,2,8,13,14,9,16,9,14,17,3,19,22,11,25
1,2,8,3,17,3,21,3,17,14,9,15,9,16,9,14,13,14,17,3,18,3,21,3,17,3,20,3,19,22,11,23,24,23,11,25,11,10,3,2,7,2,5,2,4
1,2,8,3,17,3,21,3,17,14,9,15,9,14,17,3,18,3,21,3,17,3,20,3,19,22,11,23,24,23,11,25,11,10,3,2,7,2,4,2,5,2,8,13,14,9,16
1,2,3,17,3,21,3,17,14,9,15,9,14,13,8,13,14,17,3,18,3,21,3,17,3,20,3,19,22,11,23,24,23,11,25,11,10,3,2,5,2,7,2,4,2,9,16
1,2,8,3,17,3,21,3,17,14,9,15,9,16,9,14,13,14,17,3,18,3,17,3,20,3,19,3,2,5,2,4,2,7,2,3,19,22,11,23,24,23,11,25,11,10,3,2,3,17,3,21
1,2,3,17,3,17,14,9,15,9,14,13,8,3,10,11,23,11,25,11,10,3,17,3,21,3,18,3,17,14,9,16,9,14,13,14,17,3,20,3,2,7,2,5,2,4,2,3,10,11,22,19,22,11,23,24,23,11,25
1,2,8,3,17,3,21,3,17,14,9,15,9,14,17,3,18,3,21,3,17,14,13,14,17,3,20,3,19,3,2,7,2,4,2,5,2,3,19,22,11,23,24,23,11,25,11,22,19,3,17,14,9,16
1,2,3,17,3,21,3,17,14,9,15,9,14,9,8,13,14,17,3,20,3,19,22,11,23,24,23,11,10,3,2,5,2,4,2,7,2,3,17,3,18,3,21,3,17,14,9,16,9,14,17,3,19,22,11,25
1,2,8,3,17,3,21,3,17,3,17,14,9,15,9,16,9,14,17,3,18,3,21,3,17,3,20,3,19,22,11,23,24,23,11,25,11,10,3,2,7,2,4,2,5,2,8,13
1,2,8,3,17,3,21,3,17,14,9,15,9,14,17,3,18,3,21,3,17,3,20,3,19,3,2,7,2,4,2,5,2,8,13,14,9,16,9,14,17,3,19,22,11,23,24,23,11,25
1,2,8,3,17,3,21,3,17,3,2,8,9,15,9,14,17,3,18,3,21,3,17,3,20,3,19,3,2,7,2,4,2,5,2,8,13,14,9,16,9,14,17,3,19,22,11,23,24,23,11,25
1,2,3,17,3,21,3,17,14,9,15,9,14,13,8,13,14,17,3,18,3,21,3,17,3,20,3,19,22,11,23,24,23,11,25,11,10,3,2,7,2,5,2,4,2,9,16
1,2,8,3,17,3,21,3,17,14,9,15,9,14,17,3,18,3,17,14,13,8,2,5,2,4,2,7,2,3,19,22,11,23,24,23,11,25,11,22,19,3,20,3,17,3,21,3,17,14,9,16
1,2,8,3,17,3,17,14,9,15,9,14,17,3,21,3,18,3,17,14,9,16,9,14,13,14,17,3,20,3,19,3,2,7,2,5,2,4,2,3,19,22,11,23,24,23,11,25
1,2,8,3,17,3,21,3,17,3,10,11,10,3,8,9,15,9,14,13,14,17,3,18,3,21,3,17,3,20,3,19,22,11,25,11,10,3,2,5,2,7,2,3,10,11,23,24,23,11,10,3,2,4,2,9,16
1,2,3,17,3,21,3,17,3,8,3,10,11,23,11,10,3,8,9,15,9,14,13,14,17,3,18,3,21,3,17,3,20,3,2,7,2,5,2,4,2,3,19,22,11,23,24,23,11,25,11,22,19,3,17,14,9,16
